###########
#P    #   #
# ### # # #
#   # # # #
### # # ###
#   # #   #
# ### ### #
#   # #   #
### ### # #
#.      # #
###########
